af = afr
am = amh
ar = ara
az = aze+aze_cyrl
be = bel
bn = ben
bs = bos
bg = bul
ca = cat
ceb = ceb
cs = ces
zh-cn = chi_sim+chi_sim_vert
zh-tw = chi_tra+chi_tra_vert
co = cos
cy = cym
da = dan
de = deu
el = ell
en = eng
eo = epo
et = est
eu = eus
fa = fas
tl = fil
fi = fin
fr = fra
fy = fry
gd = gla
ga = gle
gl = glg
gu = guj
ht = hat
ha = heb
hi = hin
hr = hrv
hu = hun
id = ind
is = isl
it = ita+ita_old
jw = jav
ja = jpn+jpn_vert
kn = kan
ka = kat+kat_old
kk = kaz
km = khm
ko = kor
lo = lao
la = lat
lv = lav
lt = lit
lb = ltz
ml = mal
mr = mar
mk = mkd
mt = mlt
mn = mon
mi = mri
ms = msa
my = mya
ne = nep
nl = nld
no = nor
pl = pol
pt = por
ro = ron
ru = rus
si = sin
sk = slk
sl = slv
sd = snd
es = spa+spa_old
sq = sqi
sr = srp+srp_latn
su = sun
sw = swa
sv = swe
ta = tam
te = tel
tg = tgk
th = tha
tr = tur
ug = uig
uk = ukr
ur = urd
uz = uzb+uzb_cyrl
vi = vie
yi = yid
yo = yor